11111
100P1
1C0E1
1V001
11111
