11110
100P1
1C0E1
10000
11111
