11111
100P1
1C0E1
10001
11110
